+++++++++#+
+0000000+0+
+0+0+++0+0+
+000+000+0+
+00++++++0+
+000+000+0+
+0+0+++0+0+
+000+000+0+
+0+++++0+0+
+000000000+
+++++++*+++
